,state,age_bin,female,male,total
0,abia,0 to 1,40423,41981,82404
1,abia,1 to 4,151523,156985,308508
2,abia,10 to 14,225399,224725,450124
3,abia,15 to 19,202274,205808,408082
4,abia,20 to 24,152531,167358,319889
5,abia,25 to 29,125504,130081,255585
6,abia,30 to 34,110957,108092,219049
7,abia,35 to 39,104456,93081,197537
8,abia,40 to 44,82230,84397,166627
9,abia,45 to 49,75238,74798,150036
10,abia,5 to 9,191172,198050,389222
11,abia,50 to 54,59550,56828,116378
12,abia,55 to 59,56281,51034,107315
13,abia,60 to 64,39492,33037,72529
14,abia,65 to 69,35878,31895,67773
15,abia,70 to 74,23348,18903,42251
16,abia,75 to 79,15895,13832,29727
17,abia,80 to 100,9723,6840,16563
18,abuja,0 to 1,76035,76103,152138
19,abuja,1 to 4,285011,284580,569591
20,abuja,10 to 14,264670,225784,490454
21,abuja,15 to 19,209070,186954,396024
22,abuja,20 to 24,222378,227362,449740
23,abuja,25 to 29,225464,288414,513878
24,abuja,30 to 34,176123,247352,423475
25,abuja,35 to 39,135579,214302,349881
26,abuja,40 to 44,83887,135502,219389
27,abuja,45 to 49,60454,109254,169708
28,abuja,5 to 9,287056,274040,561096
29,abuja,50 to 54,37018,57013,94031
30,abuja,55 to 59,31244,48161,79405
31,abuja,60 to 64,17626,19042,36668
32,abuja,65 to 69,16229,16296,32525
33,abuja,70 to 74,10101,7467,17568
34,abuja,75 to 79,6456,5234,11690
35,abuja,80 to 100,4633,3572,8205
36,adamawa,0 to 1,92145,96416,188561
37,adamawa,1 to 4,345401,360540,705941
38,adamawa,10 to 14,318809,323087,641896
39,adamawa,15 to 19,260245,264414,524659
40,adamawa,20 to 24,214749,210999,425748
41,adamawa,25 to 29,179334,182463,361797
42,adamawa,30 to 34,152601,159604,312205
43,adamawa,35 to 39,121020,137624,258644
44,adamawa,40 to 44,103929,106350,210279
45,adamawa,45 to 49,75337,83054,158391
46,adamawa,5 to 9,378061,389197,767258
47,adamawa,50 to 54,70499,63149,133648
48,adamawa,55 to 59,52617,55085,107702
49,adamawa,60 to 64,47828,37914,85742
50,adamawa,65 to 69,35196,33669,68865
51,adamawa,70 to 74,31269,24228,55497
52,adamawa,75 to 79,16402,15426,31828
53,adamawa,80 to 100,11181,8584,19765
54,akwa ibom,0 to 1,40531,42891,83422
55,akwa ibom,1 to 4,151929,160386,312315
56,akwa ibom,10 to 14,210296,218871,429167
57,akwa ibom,15 to 19,190561,202497,393058
58,akwa ibom,20 to 24,145048,167262,312310
59,akwa ibom,25 to 29,122667,129436,252103
60,akwa ibom,30 to 34,108085,104277,212362
61,akwa ibom,35 to 39,104887,94330,199217
62,akwa ibom,40 to 44,80427,81704,162131
63,akwa ibom,45 to 49,72948,71273,144221
64,akwa ibom,5 to 9,200235,212807,413042
65,akwa ibom,50 to 54,53756,53942,107698
66,akwa ibom,55 to 59,46986,43812,90798
67,akwa ibom,60 to 64,35757,34616,70373
68,akwa ibom,65 to 69,29692,26498,56190
69,akwa ibom,70 to 74,15159,15669,30828
70,akwa ibom,75 to 79,8836,8995,17831
71,akwa ibom,80 to 100,4190,4175,8365
72,anambra,0 to 1,59104,61708,120812
73,anambra,1 to 4,221546,230754,452300
74,anambra,10 to 14,330847,339256,670103
75,anambra,15 to 19,300497,314297,614794
76,anambra,20 to 24,235927,261536,497463
77,anambra,25 to 29,193542,198827,392369
78,anambra,30 to 34,166514,159562,326076
79,anambra,35 to 39,159001,140034,299035
80,anambra,40 to 44,123315,126986,250301
81,anambra,45 to 49,113640,111471,225111
82,anambra,5 to 9,289163,305252,594415
83,anambra,50 to 54,82780,87514,170294
84,anambra,55 to 59,84198,75700,159898
85,anambra,60 to 64,52518,52925,105443
86,anambra,65 to 69,51537,48341,99878
87,anambra,70 to 74,29357,28319,57676
88,anambra,75 to 79,22646,20069,42715
89,anambra,80 to 100,10656,9413,20069
90,bauchi,0 to 1,171727,182282,354009
91,bauchi,1 to 4,643708,681629,1325337
92,bauchi,10 to 14,516733,564168,1080901
93,bauchi,15 to 19,431665,443293,874958
94,bauchi,20 to 24,352148,326328,678476
95,bauchi,25 to 29,295155,284723,579878
96,bauchi,30 to 34,248632,256078,504710
97,bauchi,35 to 39,192571,213723,406294
98,bauchi,40 to 44,160130,175173,335303
99,bauchi,45 to 49,109196,127122,236318
100,bauchi,5 to 9,646981,689271,1336252
101,bauchi,50 to 54,102560,107819,210379
102,bauchi,55 to 59,63683,72657,136340
103,bauchi,60 to 64,63021,61233,124254
104,bauchi,65 to 69,37308,39640,76948
105,bauchi,70 to 74,35460,36485,71945
106,bauchi,75 to 79,18136,19379,37515
107,bauchi,80 to 100,14641,13219,27860
108,bayelsa,0 to 1,13618,14331,27949
109,bayelsa,1 to 4,51047,53588,104635
110,bayelsa,10 to 14,67284,71401,138685
111,bayelsa,15 to 19,60101,66318,126419
112,bayelsa,20 to 24,46412,54512,100924
113,bayelsa,25 to 29,40425,43367,83792
114,bayelsa,30 to 34,36110,36392,72502
115,bayelsa,35 to 39,34102,31851,65953
116,bayelsa,40 to 44,25428,27573,53001
117,bayelsa,45 to 49,22446,22648,45094
118,bayelsa,5 to 9,67603,72512,140115
119,bayelsa,50 to 54,15959,17822,33781
120,bayelsa,55 to 59,14324,13139,27463
121,bayelsa,60 to 64,10245,10553,20798
122,bayelsa,65 to 69,8123,7428,15551
123,bayelsa,70 to 74,4315,5275,9590
124,bayelsa,75 to 79,3091,2968,6059
125,bayelsa,80 to 100,1717,1725,3442
126,benue,0 to 1,186430,195754,382184
127,benue,1 to 4,698821,732007,1430828
128,benue,10 to 14,655373,664669,1320042
129,benue,15 to 19,536843,553731,1090574
130,benue,20 to 24,425940,427523,853463
131,benue,25 to 29,338567,352817,691384
132,benue,30 to 34,286341,301660,588001
133,benue,35 to 39,227005,253226,480231
134,benue,40 to 44,195918,197891,393809
135,benue,45 to 49,140656,159399,300055
136,benue,5 to 9,754417,772770,1527187
137,benue,50 to 54,126928,121633,248561
138,benue,55 to 59,90880,90246,181126
139,benue,60 to 64,96731,71031,167762
140,benue,65 to 69,64109,51042,115151
141,benue,70 to 74,51489,40258,91747
142,benue,75 to 79,30502,27122,57624
143,benue,80 to 100,23165,18533,41698
144,borno,0 to 1,116686,124799,241485
145,borno,1 to 4,437390,466675,904065
146,borno,10 to 14,342735,384635,727370
147,borno,15 to 19,293922,303598,597520
148,borno,20 to 24,259300,242136,501436
149,borno,25 to 29,210462,215947,426409
150,borno,30 to 34,185691,204254,389945
151,borno,35 to 39,132272,160882,293154
152,borno,40 to 44,125646,143272,268918
153,borno,45 to 49,76228,94936,171164
154,borno,5 to 9,458865,495535,954400
155,borno,50 to 54,81788,88711,170499
156,borno,55 to 59,46541,55066,101607
157,borno,60 to 64,54497,55521,110018
158,borno,65 to 69,28601,29695,58296
159,borno,70 to 74,30949,30317,61266
160,borno,75 to 79,13279,13191,26470
161,borno,80 to 100,11201,10505,21706
162,cross river,0 to 1,26733,28021,54754
163,cross river,1 to 4,100206,104782,204988
164,cross river,10 to 14,129876,132791,262667
165,cross river,15 to 19,115648,118619,234267
166,cross river,20 to 24,93204,104007,197211
167,cross river,25 to 29,75937,84423,160360
168,cross river,30 to 34,65216,65789,131005
169,cross river,35 to 39,60433,58369,118802
170,cross river,40 to 44,46971,49543,96514
171,cross river,45 to 49,40305,42560,82865
172,cross river,5 to 9,126962,133941,260903
173,cross river,50 to 54,30775,31446,62221
174,cross river,55 to 59,23470,23904,47374
175,cross river,60 to 64,19858,17578,37436
176,cross river,65 to 69,15303,13761,29064
177,cross river,70 to 74,9240,8190,17430
178,cross river,75 to 79,6025,5212,11237
179,cross river,80 to 100,3157,2800,5957
180,delta,0 to 1,52386,54318,106704
181,delta,1 to 4,196366,203118,399484
182,delta,10 to 14,254485,256177,510662
183,delta,15 to 19,223101,232466,455567
184,delta,20 to 24,181671,201252,382923
185,delta,25 to 29,148333,158256,306589
186,delta,30 to 34,128370,127742,256112
187,delta,35 to 39,120498,112776,233274
188,delta,40 to 44,92848,91981,184829
189,delta,45 to 49,87189,81296,168485
190,delta,5 to 9,238403,246917,485320
191,delta,50 to 54,64604,60368,124972
192,delta,55 to 59,65680,56124,121804
193,delta,60 to 64,40794,34982,75776
194,delta,65 to 69,39699,33397,73096
195,delta,70 to 74,24490,19056,43546
196,delta,75 to 79,18919,14875,33794
197,delta,80 to 100,10501,6731,17232
198,ebonyi,0 to 1,50902,52311,103213
199,ebonyi,1 to 4,190801,195611,386412
200,ebonyi,10 to 14,211565,209915,421480
201,ebonyi,15 to 19,186825,175893,362718
202,ebonyi,20 to 24,132237,132616,264853
203,ebonyi,25 to 29,113211,99685,212896
204,ebonyi,30 to 34,100287,85399,185686
205,ebonyi,35 to 39,93757,76612,170369
206,ebonyi,40 to 44,76251,68234,144485
207,ebonyi,45 to 49,68423,58992,127415
208,ebonyi,5 to 9,224286,224331,448617
209,ebonyi,50 to 54,48706,46590,95296
210,ebonyi,55 to 59,42151,34839,76990
211,ebonyi,60 to 64,33691,28933,62624
212,ebonyi,65 to 69,26799,22666,49465
213,ebonyi,70 to 74,15006,13687,28693
214,ebonyi,75 to 79,9679,9028,18707
215,ebonyi,80 to 100,5870,5059,10929
216,edo,0 to 1,50630,53361,103991
217,edo,1 to 4,189783,199541,389324
218,edo,10 to 14,241115,242294,483409
219,edo,15 to 19,211145,223643,434788
220,edo,20 to 24,183819,218917,402736
221,edo,25 to 29,145982,177454,323436
222,edo,30 to 34,121163,128584,249747
223,edo,35 to 39,114965,110363,225328
224,edo,40 to 44,88269,83666,171935
225,edo,45 to 49,84453,78366,162819
226,edo,5 to 9,228124,236864,464988
227,edo,50 to 54,62203,55815,118018
228,edo,55 to 59,65997,58457,124454
229,edo,60 to 64,39897,32159,72056
230,edo,65 to 69,39862,32514,72376
231,edo,70 to 74,23828,17124,40952
232,edo,75 to 79,17953,12869,30822
233,edo,80 to 100,11342,6695,18037
234,ekiti,0 to 1,19163,20237,39400
235,ekiti,1 to 4,71833,75674,147507
236,ekiti,10 to 14,111554,115676,227230
237,ekiti,15 to 19,100610,107853,208463
238,ekiti,20 to 24,83990,97907,181897
239,ekiti,25 to 29,60318,67565,127883
240,ekiti,30 to 34,49885,48723,98608
241,ekiti,35 to 39,49578,42651,92229
242,ekiti,40 to 44,37988,38194,76182
243,ekiti,45 to 49,35930,32873,68803
244,ekiti,5 to 9,98290,104119,202409
245,ekiti,50 to 54,25609,26192,51801
246,ekiti,55 to 59,25941,20457,46398
247,ekiti,60 to 64,17189,15920,33109
248,ekiti,65 to 69,15237,12952,28189
249,ekiti,70 to 74,7723,8293,16016
250,ekiti,75 to 79,5442,4590,10032
251,ekiti,80 to 100,3343,2547,5890
252,enugu,0 to 1,53845,54673,108518
253,enugu,1 to 4,201833,204447,406280
254,enugu,10 to 14,287868,280537,568405
255,enugu,15 to 19,267726,253385,521111
256,enugu,20 to 24,217892,222480,440372
257,enugu,25 to 29,163658,162707,326365
258,enugu,30 to 34,140215,120512,260727
259,enugu,35 to 39,135164,109204,244368
260,enugu,40 to 44,111801,99983,211784
261,enugu,45 to 49,105825,95138,200963
262,enugu,5 to 9,250211,256977,507188
263,enugu,50 to 54,81649,74147,155796
264,enugu,55 to 59,78073,68396,146469
265,enugu,60 to 64,56124,48175,104299
266,enugu,65 to 69,51362,45357,96719
267,enugu,70 to 74,29234,27275,56509
268,enugu,75 to 79,19166,16108,35274
269,enugu,80 to 100,9660,7738,17398
270,gombe,0 to 1,80366,86877,167243
271,gombe,1 to 4,301247,324868,626115
272,gombe,10 to 14,241295,295212,536507
273,gombe,15 to 19,201669,237989,439658
274,gombe,20 to 24,162851,168426,331277
275,gombe,25 to 29,138659,138413,277072
276,gombe,30 to 34,114169,123894,238063
277,gombe,35 to 39,89713,103778,193491
278,gombe,40 to 44,73080,81938,155018
279,gombe,45 to 49,52682,60525,113207
280,gombe,5 to 9,296963,340379,637342
281,gombe,50 to 54,47199,48733,95932
282,gombe,55 to 59,32856,35042,67898
283,gombe,60 to 64,29362,28216,57578
284,gombe,65 to 69,20074,20462,40536
285,gombe,70 to 74,17660,16347,34007
286,gombe,75 to 79,9219,10565,19784
287,gombe,80 to 100,6238,5382,11620
288,imo,0 to 1,69277,71796,141073
289,imo,1 to 4,259680,268474,528154
290,imo,10 to 14,367915,372752,740667
291,imo,15 to 19,334039,347780,681819
292,imo,20 to 24,262104,296505,558609
293,imo,25 to 29,210354,217804,428158
294,imo,30 to 34,187321,172224,359545
295,imo,35 to 39,178387,152631,331018
296,imo,40 to 44,143394,138170,281564
297,imo,45 to 49,133013,125526,258539
298,imo,5 to 9,322186,340669,662855
299,imo,50 to 54,100182,98369,198551
300,imo,55 to 59,96625,85902,182527
301,imo,60 to 64,68998,59822,128820
302,imo,65 to 69,66352,53739,120091
303,imo,70 to 74,37990,33357,71347
304,imo,75 to 79,28374,23609,51983
305,imo,80 to 100,13091,11215,24306
306,jigawa,0 to 1,126421,138283,264704
307,jigawa,1 to 4,473881,517097,990978
308,jigawa,10 to 14,357262,375424,732686
309,jigawa,15 to 19,303778,290677,594455
310,jigawa,20 to 24,267275,207832,475107
311,jigawa,25 to 29,223530,191163,414693
312,jigawa,30 to 34,204954,202999,407953
313,jigawa,35 to 39,141408,157927,299335
314,jigawa,40 to 44,133266,147215,280481
315,jigawa,45 to 49,74996,88253,163249
316,jigawa,5 to 9,490084,510930,1001014
317,jigawa,50 to 54,85123,96327,181450
318,jigawa,55 to 59,42629,45683,88312
319,jigawa,60 to 64,53755,58633,112388
320,jigawa,65 to 69,24436,24912,49348
321,jigawa,70 to 74,32582,37534,70116
322,jigawa,75 to 79,11496,12075,23571
323,jigawa,80 to 100,12975,13414,26389
324,kaduna,0 to 1,218202,224388,442590
325,kaduna,1 to 4,817915,839081,1656996
326,kaduna,10 to 14,668881,698017,1366898
327,kaduna,15 to 19,561026,565346,1126372
328,kaduna,20 to 24,468250,448026,916276
329,kaduna,25 to 29,395598,399220,794818
330,kaduna,30 to 34,323778,345589,669367
331,kaduna,35 to 39,257806,295727,553533
332,kaduna,40 to 44,207257,228125,435382
333,kaduna,45 to 49,150115,174968,325083
334,kaduna,5 to 9,824284,841128,1665412
335,kaduna,50 to 54,128855,132845,261700
336,kaduna,55 to 59,94749,107811,202560
337,kaduna,60 to 64,74014,72337,146351
338,kaduna,65 to 69,53432,53984,107416
339,kaduna,70 to 74,46854,40320,87174
340,kaduna,75 to 79,25666,24289,49955
341,kaduna,80 to 100,21274,18125,39399
342,kano,0 to 1,353387,377421,730808
343,kano,1 to 4,1324649,1411334,2735983
344,kano,10 to 14,1007618,1215852,2223470
345,kano,15 to 19,844988,985678,1830666
346,kano,20 to 24,728681,702022,1430703
347,kano,25 to 29,616778,611479,1228257
348,kano,30 to 34,533331,566342,1099673
349,kano,35 to 39,387315,458323,845638
350,kano,40 to 44,347802,397220,745022
351,kano,45 to 49,209051,259790,468841
352,kano,5 to 9,1345204,1459752,2804956
353,kano,50 to 54,222000,248943,470943
354,kano,55 to 59,120152,147889,268041
355,kano,60 to 64,134084,146179,280263
356,kano,65 to 69,67257,75438,142695
357,kano,70 to 74,87074,88281,175355
358,kano,75 to 79,33252,34448,67700
359,kano,80 to 100,37447,33648,71095
360,katsina,0 to 1,199187,215216,414403
361,katsina,1 to 4,746641,804782,1551423
362,katsina,10 to 14,560244,612669,1172913
363,katsina,15 to 19,462220,467289,929509
364,katsina,20 to 24,392637,340386,733023
365,katsina,25 to 29,335348,305127,640475
366,katsina,30 to 34,283652,290686,574338
367,katsina,35 to 39,214314,241869,456183
368,katsina,40 to 44,183761,203106,386867
369,katsina,45 to 49,118871,139784,258655
370,katsina,5 to 9,735769,788946,1524715
371,katsina,50 to 54,117380,127197,244577
372,katsina,55 to 59,67965,74432,142397
373,katsina,60 to 64,72722,73646,146368
374,katsina,65 to 69,38938,38902,77840
375,katsina,70 to 74,42519,42465,84984
376,katsina,75 to 79,18814,19829,38643
377,katsina,80 to 100,16655,15739,32394
378,kebbi,0 to 1,113722,120427,234149
379,kebbi,1 to 4,426280,450327,876607
380,kebbi,10 to 14,325984,344609,670593
381,kebbi,15 to 19,266039,262446,528485
382,kebbi,20 to 24,232610,191567,424177
383,kebbi,25 to 29,201590,186845,388435
384,kebbi,30 to 34,165974,170092,336066
385,kebbi,35 to 39,123638,141020,264658
386,kebbi,40 to 44,108697,113707,222404
387,kebbi,45 to 49,64557,78286,142843
388,kebbi,5 to 9,455156,459841,914997
389,kebbi,50 to 54,70218,71145,141363
390,kebbi,55 to 59,41700,50605,92305
391,kebbi,60 to 64,45235,44934,90169
392,kebbi,65 to 69,25039,27307,52346
393,kebbi,70 to 74,26338,23570,49908
394,kebbi,75 to 79,10907,11245,22152
395,kebbi,80 to 100,9251,8011,17262
396,kogi,0 to 1,71926,75515,147441
397,kogi,1 to 4,269611,282382,551993
398,kogi,10 to 14,233384,244925,478309
399,kogi,15 to 19,195004,203060,398064
400,kogi,20 to 24,158021,157678,315699
401,kogi,25 to 29,139199,134745,273944
402,kogi,30 to 34,117155,118037,235192
403,kogi,35 to 39,97744,101383,199127
404,kogi,40 to 44,78898,81626,160524
405,kogi,45 to 49,59808,63925,123733
406,kogi,5 to 9,270573,284036,554609
407,kogi,50 to 54,49447,50649,100096
408,kogi,55 to 59,35842,32713,68555
409,kogi,60 to 64,32298,29795,62093
410,kogi,65 to 69,23712,21033,44745
411,kogi,70 to 74,15524,14594,30118
412,kogi,75 to 79,8682,8221,16903
413,kogi,80 to 100,6139,5898,12037
414,kwara,0 to 1,86024,89744,175768
415,kwara,1 to 4,322454,335591,658045
416,kwara,10 to 14,284219,299243,583462
417,kwara,15 to 19,229255,244805,474060
418,kwara,20 to 24,193178,199488,392666
419,kwara,25 to 29,172615,170386,343001
420,kwara,30 to 34,144000,146421,290421
421,kwara,35 to 39,120907,125626,246533
422,kwara,40 to 44,100566,104139,204705
423,kwara,45 to 49,76973,81021,157994
424,kwara,5 to 9,332474,348891,681365
425,kwara,50 to 54,64793,64308,129101
426,kwara,55 to 59,54762,45986,100748
427,kwara,60 to 64,42844,39089,81933
428,kwara,65 to 69,34418,30525,64943
429,kwara,70 to 74,22733,19739,42472
430,kwara,75 to 79,14995,11165,26160
431,kwara,80 to 100,9215,7018,16233
432,lagos,0 to 1,129468,130557,260025
433,lagos,1 to 4,485302,488205,973507
434,lagos,10 to 14,518193,464630,982823
435,lagos,15 to 19,465928,456947,922875
436,lagos,20 to 24,482915,598144,1081059
437,lagos,25 to 29,452990,609615,1062605
438,lagos,30 to 34,369631,495824,865455
439,lagos,35 to 39,318842,425711,744553
440,lagos,40 to 44,220556,277114,497670
441,lagos,45 to 49,185896,224549,410445
442,lagos,5 to 9,510627,499539,1010166
443,lagos,50 to 54,127279,132386,259665
444,lagos,55 to 59,125605,129677,255282
445,lagos,60 to 64,69178,59328,128506
446,lagos,65 to 69,64515,57016,121531
447,lagos,70 to 74,33655,22540,56195
448,lagos,75 to 79,25076,15612,40688
449,lagos,80 to 100,13936,6847,20783
450,nasarawa,0 to 1,93385,95781,189166
451,nasarawa,1 to 4,350048,358163,708211
452,nasarawa,10 to 14,288979,293956,582935
453,nasarawa,15 to 19,241335,244534,485869
454,nasarawa,20 to 24,210870,200597,411467
455,nasarawa,25 to 29,187639,186998,374637
456,nasarawa,30 to 34,147511,163842,311353
457,nasarawa,35 to 39,115901,139694,255595
458,nasarawa,40 to 44,87870,102833,190703
459,nasarawa,45 to 49,64755,78799,143554
460,nasarawa,5 to 9,347985,354821,702806
461,nasarawa,50 to 54,52830,56308,109138
462,nasarawa,55 to 59,40164,41639,81803
463,nasarawa,60 to 64,32334,28606,60940
464,nasarawa,65 to 69,26855,24271,51126
465,nasarawa,70 to 74,18205,17015,35220
466,nasarawa,75 to 79,11940,10650,22590
467,nasarawa,80 to 100,7978,7460,15438
468,niger,0 to 1,212710,218600,431310
469,niger,1 to 4,797329,817437,1614766
470,niger,10 to 14,612326,637220,1249546
471,niger,15 to 19,523850,499517,1023367
472,niger,20 to 24,444846,396758,841604
473,niger,25 to 29,385295,375863,761158
474,niger,30 to 34,307795,341703,649498
475,niger,35 to 39,236621,287054,523675
476,niger,40 to 44,187367,221409,408776
477,niger,45 to 49,130709,161476,292185
478,niger,5 to 9,792384,814219,1606603
479,niger,50 to 54,116297,130020,246317
480,niger,55 to 59,80416,88876,169292
481,niger,60 to 64,70278,71377,141655
482,niger,65 to 69,48495,50339,98834
483,niger,70 to 74,38403,40751,79154
484,niger,75 to 79,21681,22733,44414
485,niger,80 to 100,17616,18175,35791
486,ogun,0 to 1,119676,119871,239547
487,ogun,1 to 4,448598,448247,896845
488,ogun,10 to 14,478713,463123,941836
489,ogun,15 to 19,375992,392236,768228
490,ogun,20 to 24,342486,378995,721481
491,ogun,25 to 29,319758,345534,665292
492,ogun,30 to 34,281145,297573,578718
493,ogun,35 to 39,260567,276624,537191
494,ogun,40 to 44,192885,203473,396358
495,ogun,45 to 49,163140,170846,333986
496,ogun,5 to 9,497017,497354,994371
497,ogun,50 to 54,124619,111699,236318
498,ogun,55 to 59,121466,103390,224856
499,ogun,60 to 64,86328,60166,146494
500,ogun,65 to 69,86728,58480,145208
501,ogun,70 to 74,51404,30585,81989
502,ogun,75 to 79,36266,20928,57194
503,ogun,80 to 100,21081,9660,30741
504,ondo,0 to 1,44551,46152,90703
505,ondo,1 to 4,166997,172580,339577
506,ondo,10 to 14,215161,220423,435584
507,ondo,15 to 19,179247,197023,376270
508,ondo,20 to 24,141923,167234,309157
509,ondo,25 to 29,126040,133295,259335
510,ondo,30 to 34,111450,109905,221355
511,ondo,35 to 39,105011,97826,202837
512,ondo,40 to 44,81842,80399,162241
513,ondo,45 to 49,72436,68305,140741
514,ondo,5 to 9,208861,218486,427347
515,ondo,50 to 54,56182,52110,108292
516,ondo,55 to 59,49486,41499,90985
517,ondo,60 to 64,38515,31611,70126
518,ondo,65 to 69,30165,26976,57141
519,ondo,70 to 74,18156,16785,34941
520,ondo,75 to 79,11224,9800,21024
521,ondo,80 to 100,7850,5268,13118
522,osun,0 to 1,56646,59794,116440
523,osun,1 to 4,212334,223595,435929
524,osun,10 to 14,300416,311199,611615
525,osun,15 to 19,257494,280041,537535
526,osun,20 to 24,195378,231951,427329
527,osun,25 to 29,168949,177599,346548
528,osun,30 to 34,146564,139568,286132
529,osun,35 to 39,147847,125939,273786
530,osun,40 to 44,114237,112559,226796
531,osun,45 to 49,106741,96546,203287
532,osun,5 to 9,283202,302318,585520
533,osun,50 to 54,77911,77839,155750
534,osun,55 to 59,76259,59954,136213
535,osun,60 to 64,51191,46540,97731
536,osun,65 to 69,45699,39141,84840
537,osun,70 to 74,25280,23052,48332
538,osun,75 to 79,15554,13852,29406
539,osun,80 to 100,9481,7694,17175
540,oyo,0 to 1,91602,95142,186744
541,oyo,1 to 4,343362,355775,699137
542,oyo,10 to 14,443223,452524,895747
543,oyo,15 to 19,358018,388912,746930
544,oyo,20 to 24,295761,342408,638169
545,oyo,25 to 29,264692,278989,543681
546,oyo,30 to 34,233250,229960,463210
547,oyo,35 to 39,219553,206708,426261
548,oyo,40 to 44,169645,171933,341578
549,oyo,45 to 49,153914,145521,299435
550,oyo,5 to 9,436150,448438,884588
551,oyo,50 to 54,117137,109309,226446
552,oyo,55 to 59,114115,93208,207323
553,oyo,60 to 64,78100,66338,144438
554,oyo,65 to 69,71626,58610,130236
555,oyo,70 to 74,40770,32753,73523
556,oyo,75 to 79,27247,20338,47585
557,oyo,80 to 100,16428,10978,27406
558,plateau,0 to 1,125469,126996,252465
559,plateau,1 to 4,470313,474890,945203
560,plateau,10 to 14,459219,446557,905776
561,plateau,15 to 19,379364,375031,754395
562,plateau,20 to 24,306010,299465,605475
563,plateau,25 to 29,258425,268596,527021
564,plateau,30 to 34,211167,226836,438003
565,plateau,35 to 39,173738,199743,373481
566,plateau,40 to 44,137599,144179,281778
567,plateau,45 to 49,108425,118133,226558
568,plateau,5 to 9,517760,511513,1029273
569,plateau,50 to 54,89016,80618,169634
570,plateau,55 to 59,73069,72586,145655
571,plateau,60 to 64,57145,44469,101614
572,plateau,65 to 69,47947,43168,91115
573,plateau,70 to 74,36469,27013,63482
574,plateau,75 to 79,22438,20123,42561
575,plateau,80 to 100,15462,11282,26744
576,rivers,0 to 1,62578,66310,128888
577,rivers,1 to 4,234571,247961,482532
578,rivers,10 to 14,316588,307281,623869
579,rivers,15 to 19,291592,294212,585804
580,rivers,20 to 24,258704,289294,547998
581,rivers,25 to 29,222560,251440,474000
582,rivers,30 to 34,182069,213344,395413
583,rivers,35 to 39,157542,177787,335329
584,rivers,40 to 44,113006,138782,251788
585,rivers,45 to 49,96704,114336,211040
586,rivers,5 to 9,285542,297039,582581
587,rivers,50 to 54,68797,79495,148292
588,rivers,55 to 59,59048,63189,122237
589,rivers,60 to 64,39093,41606,80699
590,rivers,65 to 69,33685,31565,65250
591,rivers,70 to 74,17341,17791,35132
592,rivers,75 to 79,12327,11076,23403
593,rivers,80 to 100,7454,6506,13960
594,sokoto,0 to 1,147036,157493,304529
595,sokoto,1 to 4,551157,588932,1140089
596,sokoto,10 to 14,401011,439016,840027
597,sokoto,15 to 19,340423,340456,680879
598,sokoto,20 to 24,301675,244993,546668
599,sokoto,25 to 29,266850,227812,494662
600,sokoto,30 to 34,231514,218758,450272
601,sokoto,35 to 39,165176,185144,350320
602,sokoto,40 to 44,152492,158815,311307
603,sokoto,45 to 49,84558,104668,189226
604,sokoto,5 to 9,560678,588933,1149611
605,sokoto,50 to 54,102670,103582,206252
606,sokoto,55 to 59,55714,73541,129255
607,sokoto,60 to 64,65699,65775,131474
608,sokoto,65 to 69,31475,38251,69726
609,sokoto,70 to 74,37168,33535,70703
610,sokoto,75 to 79,13741,15069,28810
611,sokoto,80 to 100,13232,10557,23789
612,taraba,0 to 1,115425,122597,238022
613,taraba,1 to 4,432664,458443,891107
614,taraba,10 to 14,369378,387291,756669
615,taraba,15 to 19,308790,314870,623660
616,taraba,20 to 24,258933,242816,501749
617,taraba,25 to 29,224860,223196,448056
618,taraba,30 to 34,188001,202586,390587
619,taraba,35 to 39,145811,175607,321418
620,taraba,40 to 44,117240,136148,253388
621,taraba,45 to 49,81512,101729,183241
622,taraba,5 to 9,452552,475229,927781
623,taraba,50 to 54,69539,77055,146594
624,taraba,55 to 59,50282,56022,106304
625,taraba,60 to 64,45640,44438,90078
626,taraba,65 to 69,31212,31747,62959
627,taraba,70 to 74,24947,24374,49321
628,taraba,75 to 79,13463,15274,28737
629,taraba,80 to 100,9854,9282,19136
630,yobe,0 to 1,93277,101741,195018
631,yobe,1 to 4,349643,380453,730096
632,yobe,10 to 14,292124,327461,619585
633,yobe,15 to 19,251527,261022,512549
634,yobe,20 to 24,211434,197071,408505
635,yobe,25 to 29,168906,177821,346727
636,yobe,30 to 34,148139,171416,319555
637,yobe,35 to 39,100136,127539,227675
638,yobe,40 to 44,96367,116080,212447
639,yobe,45 to 49,54013,70289,124302
640,yobe,5 to 9,375231,409166,784397
641,yobe,50 to 54,63461,72740,136201
642,yobe,55 to 59,32563,39967,72530
643,yobe,60 to 64,40324,45162,85486
644,yobe,65 to 69,19099,21267,40366
645,yobe,70 to 74,24351,25781,50132
646,yobe,75 to 79,8529,9635,18164
647,yobe,80 to 100,8345,7831,16176
648,zamfara,0 to 1,105354,111332,216686
649,zamfara,1 to 4,394912,416317,811229
650,zamfara,10 to 14,292184,319201,611385
651,zamfara,15 to 19,253430,243753,497183
652,zamfara,20 to 24,223019,173771,396790
653,zamfara,25 to 29,190717,168153,358870
654,zamfara,30 to 34,159566,163217,322783
655,zamfara,35 to 39,112123,130869,242992
656,zamfara,40 to 44,102126,110348,212474
657,zamfara,45 to 49,57454,70131,127585
658,zamfara,5 to 9,416967,425696,842663
659,zamfara,50 to 54,67869,70262,138131
660,zamfara,55 to 59,35524,46319,81843
661,zamfara,60 to 64,41858,43809,85667
662,zamfara,65 to 69,19735,23500,43235
663,zamfara,70 to 74,24934,23686,48620
664,zamfara,75 to 79,9555,10313,19868
665,zamfara,80 to 100,9469,8374,17843
